4 4 4 4 4 4 4 4 4 4 4 4 4 4 4 4 4 4 4 4 4 4 22 22 22 22 22 3 3 3 3 2 2 2 2 2 2 2 2 3 3 3 3 3 3 3 3 3 3 3 3 3 3 3 3 3 3 3 3 3 3 3 3 3 3 3
4 4 4 4 4 4 4 4 4 4 4 4 4 4 4 4 4 4 4 4 4 4 22 22 22 22 22 3 3 3 3 2 2 2 2 2 2 2 2 3 3 3 3 3 3 3 3 3 3 3 3 3 3 3 3 3 3 3 3 3 3 3 3 3 3 3
4 4 4 4 4 4 4 4 4 4 4 4 4 4 4 4 4 4 4 4 4 4 8 22 3 3 22 3 3 3 3 2 2 2 2 2 2 2 2 3 3 3 3 3 3 3 3 3 3 3 3 3 3 3 3 3 3 3 3 3 3 3 3 3 3 3
4 4 4 4 4 4 4 4 4 4 4 0 0 4 4 4 4 4 4 4 4 4 4 8 1 1 22 3 3 3 2 2 2 2 2 2 2 2 2 3 3 3 3 1 1 3 3 3 3 3 3 3 1 3 3 3 3 3 3 3 3 3 3 3 3 3
4 4 4 4 4 4 4 4 0 0 0 0 0 4 4 4 4 4 4 4 4 4 4 4 4 4 22 3 3 2 2 2 2 2 2 2 2 2 2 3 3 3 1 1 1 1 3 3 3 3 3 1 1 3 3 3 3 3 3 3 3 3 3 3 3 3
4 4 4 4 4 4 4 4 4 4 4 4 4 4 4 4 4 4 4 4 4 4 4 4 4 4 22 3 3 2 2 2 2 2 2 2 2 2 2 3 3 3 1 1 1 1 1 1 1 1 1 1 1 1 3 3 3 3 3 3 3 3 3 3 3 3
4 4 4 4 4 4 4 4 4 4 4 4 4 0 0 0 0 0 0 0 0 0 0 0 0 0 22 3 3 2 2 2 2 2 2 2 2 2 2 3 3 3 1 1 1 1 1 1 1 10 1 1 1 1 1 1 3 3 3 3 3 3 3 1 1 3
4 4 4 4 4 4 4 4 4 4 0 0 0 6 21 21 21 21 7 0 0 0 0 0 0 0 22 1 1 3 3 3 3 2 2 3 3 3 3 1 1 1 1 1 9 4 4 4 4 0 0 0 4 4 8 1 1 3 3 3 3 3 1 1 1 1
4 4 4 4 4 4 4 4 4 4 0 0 0 22 5 5 5 5 23 0 0 0 0 0 0 0 8 1 1 1 1 1 1 2 2 1 1 1 1 1 1 9 4 4 4 4 4 6 21 21 7 0 0 0 0 8 1 3 1 1 1 1 1 1 1 1
4 4 4 4 4 4 4 4 4 0 0 0 0 22 5 5 5 5 23 0 0 0 0 0 0 0 0 8 1 1 1 1 1 2 2 1 1 1 1 1 9 4 4 4 6 1 1 1 5 5 1 1 1 7 0 4 1 1 1 1 1 1 1 1 1 1
4 4 4 4 4 4 4 4 4 0 0 0 4 8 5 5 5 5 9 4 0 0 0 0 0 0 0 0 8 1 1 1 1 2 2 1 1 1 1 9 4 0 0 4 1 5 5 5 5 5 5 5 5 1 0 4 8 1 1 1 1 1 1 1 1 1
4 4 4 0 0 4 4 4 4 0 0 0 0 0 0 5 5 0 0 0 0 0 0 0 0 0 0 0 0 0 0 0 0 2 2 4 4 4 0 0 0 0 0 0 1 5 5 5 5 5 5 5 5 1 0 0 4 8 1 1 1 1 1 1 1 1
4 4 4 4 4 4 4 4 4 0 0 0 0 0 0 5 5 0 0 0 0 0 0 0 0 0 0 0 0 0 0 11 12 2 2 12 12 12 13 0 0 0 0 4 1 3 3 4 5 5 4 3 3 1 4 0 4 4 4 4 4 4 4 4 4 4
4 4 4 4 4 4 4 4 4 4 0 0 0 0 0 0 0 0 0 0 0 0 0 0 0 0 0 11 12 12 12 20 2 2 2 2 2 2 19 12 12 13 0 4 8 1 1 4 5 5 4 1 1 9 4 0 4 4 4 4 4 4 4 4 0 0
4 4 4 4 4 4 4 4 4 4 4 0 0 0 0 0 0 0 0 0 0 0 0 0 0 0 0 17 2 2 2 2 2 2 2 2 2 2 2 2 2 18 0 0 0 0 0 0 5 5 0 0 0 0 0 0 4 4 4 4 4 4 4 0 0 0
4 4 4 4 4 4 4 4 4 4 4 0 0 0 0 0 0 0 0 0 0 0 0 0 0 0 11 20 2 2 2 2 2 2 0 0 2 2 2 2 2 18 0 0 0 0 0 0 5 5 0 0 0 0 0 4 4 4 4 4 4 4 4 0 0 0
4 4 4 4 4 4 4 4 4 4 4 4 0 0 0 0 0 0 0 0 0 4 4 0 0 11 20 2 2 2 2 2 2 0 5 4 0 2 2 2 2 19 13 0 0 0 0 0 5 5 0 0 0 0 0 0 0 0 4 4 4 4 5 0 0 0
4 4 4 4 4 4 4 4 4 4 4 4 4 4 4 0 0 0 0 4 4 4 4 4 4 17 2 2 2 2 2 2 2 0 0 0 0 2 2 2 2 2 19 12 12 12 12 13 5 5 11 12 12 12 12 12 12 12 12 12 12 13 5 11 12 12
4 4 4 4 4 4 4 4 4 4 4 4 4 4 4 4 0 0 4 4 4 4 4 4 4 14 25 2 2 2 2 2 2 0 0 2 2 2 2 2 2 2 2 2 24 15 15 16 5 5 14 15 15 15 15 15 15 15 15 15 15 16 5 14 15 15
4 4 4 4 4 4 4 4 4 4 4 4 4 4 0 0 0 0 0 0 0 4 4 4 0 0 17 2 2 2 2 2 2 2 2 2 2 2 2 2 2 24 15 15 16 0 0 0 5 5 0 0 0 0 0 0 0 0 4 4 4 4 5 4 4 4
4 4 4 4 4 4 4 4 4 4 4 4 0 0 0 0 0 0 0 0 0 0 4 0 0 0 14 15 25 2 2 2 2 2 2 2 2 2 24 15 15 16 0 0 0 0 0 0 5 5 0 0 0 0 0 0 0 0 4 4 4 4 4 4 4 4
4 4 4 4 4 4 4 4 4 4 4 0 0 0 0 0 0 0 0 0 0 0 0 0 0 0 0 0 14 15 15 15 15 15 15 25 2 24 16 0 0 0 0 0 0 0 5 5 5 5 5 5 5 0 0 0 0 0 4 4 4 4 4 4 4 4
4 4 4 4 4 4 4 4 4 4 4 0 0 0 0 0 0 0 0 0 0 0 4 0 0 0 0 0 0 0 0 0 0 0 0 14 25 18 0 0 0 0 0 0 0 0 0 0 0 0 0 0 0 0 0 0 0 0 4 4 4 4 4 4 4 4
4 4 4 4 4 4 4 4 4 4 0 0 0 0 0 0 0 0 0 0 0 0 0 0 0 0 0 0 0 0 0 0 0 0 0 0 17 18 0 0 0 0 0 0 0 0 0 0 0 0 0 0 0 0 0 0 4 4 4 4 4 4 4 4 4 4
4 4 4 4 4 4 4 4 4 4 0 0 0 0 0 0 0 0 0 0 0 0 0 0 0 0 0 0 0 0 0 0 0 0 0 0 17 18 0 0 0 0 0 0 0 0 0 0 0 0 0 0 0 0 4 4 4 4 4 4 4 4 4 4 4 4
4 4 4 4 4 4 4 4 4 0 0 0 0 0 0 0 0 0 0 0 0 0 0 0 0 0 0 0 0 0 0 0 0 0 0 0 17 18 0 0 0 0 0 0 0 0 0 0 0 0 0 0 0 4 4 4 4 4 4 4 4 4 4 4 4 4
4 4 4 4 4 4 4 4 0 0 0 0 0 0 0 0 0 6 21 21 21 7 0 0 0 0 0 0 0 0 0 0 0 0 0 0 17 18 0 0 0 0 0 0 0 0 0 0 0 0 0 0 0 4 4 4 4 4 4 4 4 4 4 4 4 4
4 4 4 4 4 4 4 4 0 0 0 0 0 0 0 0 0 1 5 5 5 23 0 0 0 0 5 0 0 0 0 0 0 0 0 0 17 18 0 0 0 0 0 0 0 0 0 0 0 0 0 0 0 0 4 4 4 4 4 4 4 4 4 4 4 4
4 4 4 4 4 4 4 4 0 0 0 0 4 6 21 21 21 21 21 5 23 4 0 0 0 0 5 0 0 0 0 0 0 0 0 0 17 18 0 0 0 0 0 0 0 0 0 0 0 0 0 0 0 0 0 4 4 4 4 4 4 4 4 4 4 4
4 4 4 4 4 4 4 4 0 0 0 0 4 22 5 5 5 5 5 5 23 4 4 0 0 0 5 0 0 0 0 0 0 0 0 0 14 16 0 0 0 0 0 0 0 0 0 0 0 0 0 0 0 0 0 4 4 4 4 4 4 4 4 4 4 4
4 4 4 4 4 4 4 4 4 4 0 5 5 5 5 5 5 5 5 5 5 5 5 5 5 5 5 5 5 5 5 0 0 0 0 0 0 0 0 0 0 0 0 0 0 0 0 0 0 0 0 0 0 0 0 0 4 4 4 4 4 4 4 4 4 4
4 4 4 4 4 4 4 4 5 5 5 5 4 22 5 5 5 5 5 5 5 5 5 5 5 5 5 5 0 0 0 0 0 0 0 0 0 0 0 0 0 0 0 0 0 0 0 0 0 0 0 0 0 0 0 0 0 0 4 4 4 4 4 4 4 4
4 4 4 4 4 4 4 4 4 4 0 0 4 8 1 5 5 1 1 1 9 4 4 0 0 0 0 0 4 4 0 0 0 0 0 0 11 13 0 0 0 0 0 0 0 4 4 0 0 0 0 0 0 0 0 0 0 4 4 4 4 4 4 4 4 4
4 4 4 4 4 4 4 4 4 0 0 0 0 0 0 5 5 0 0 0 0 0 0 0 0 0 0 0 4 4 0 0 0 0 0 0 17 18 0 0 0 0 0 0 0 0 0 0 0 0 0 0 0 0 0 0 4 4 4 4 4 4 4 4 4 4
4 4 4 4 4 4 4 4 4 4 0 0 0 0 0 5 5 0 0 0 0 0 0 0 0 0 0 0 0 0 0 0 0 0 0 0 17 18 0 0 0 0 0 0 4 4 0 0 0 0 0 0 0 0 0 0 0 0 4 4 4 4 4 4 4 4
4 4 4 4 4 4 4 4 4 4 0 4 0 0 0 5 5 0 0 0 0 0 0 0 0 4 0 0 0 0 0 0 0 4 4 0 17 18 0 0 0 4 4 4 4 4 0 0 0 0 0 0 0 0 0 0 0 4 4 4 4 4 4 4 4 4
4 4 4 4 4 4 4 4 4 4 0 4 4 0 0 5 5 0 0 0 0 0 0 0 4 4 4 4 4 4 4 4 4 4 4 4 17 18 0 0 0 4 4 4 4 4 4 4 0 0 0 0 0 0 0 0 0 4 4 4 4 4 4 4 4 4
4 4 4 4 4 4 4 4 4 4 0 0 0 0 0 5 5 0 0 0 0 0 0 4 4 4 4 4 4 4 4 4 4 4 4 4 17 19 13 0 4 4 4 4 0 0 4 4 4 4 0 0 0 0 0 0 0 0 4 4 4 4 4 4 4 4
4 4 4 4 4 4 4 4 4 0 0 0 0 0 0 5 5 0 0 0 0 0 0 4 4 4 4 4 4 4 4 4 4 4 4 4 14 25 18 4 4 4 4 4 0 0 4 4 4 4 4 4 0 0 5 0 0 0 4 4 4 4 4 4 4 4
4 4 4 5 5 4 4 4 4 0 0 0 0 0 0 5 5 0 0 0 0 0 0 4 4 4 4 4 4 4 4 4 4 4 4 4 4 17 18 4 4 4 4 4 4 4 4 4 4 4 4 4 4 0 5 0 0 4 4 4 4 4 4 4 4 4
4 4 4 5 5 4 4 4 5 5 0 0 0 0 0 5 5 0 0 0 0 0 0 0 0 4 4 0 0 4 4 4 4 4 4 4 4 17 18 4 4 4 4 4 4 4 4 4 4 4 4 4 4 4 5 0 4 4 4 4 4 4 4 4 4 4
12 12 12 12 12 12 12 13 5 5 5 0 0 5 5 5 5 5 0 0 0 0 5 5 5 4 4 0 0 5 5 4 4 4 4 4 11 20 18 0 0 4 4 4 0 0 0 0 0 4 0 0 4 4 5 4 4 4 4 4 4 4 4 4 4 0
2 2 2 2 2 2 2 18 5 5 5 5 5 5 5 5 5 5 5 5 5 5 5 5 5 5 5 5 5 5 5 5 5 5 11 12 20 2 19 13 0 0 0 4 4 4 4 0 4 4 4 4 4 0 5 0 4 4 4 4 4 4 4 4 4 4
2 2 2 2 2 2 2 18 5 5 5 5 5 5 5 5 5 5 5 5 5 5 5 5 5 5 5 5 5 5 5 5 11 12 20 2 2 2 2 19 13 0 0 0 4 4 4 4 0 0 0 0 0 0 5 5 0 4 4 4 4 4 4 4 4 4
2 2 2 2 2 2 2 19 12 12 12 12 12 12 12 13 5 5 5 11 12 13 5 5 5 5 5 5 5 5 5 11 20 2 2 2 2 2 2 2 19 13 0 0 0 0 0 0 0 0 5 5 5 5 5 5 5 5 4 4 4 4 4 4 4 4
2 2 2 2 2 2 2 2 2 2 2 2 2 2 2 19 12 12 12 20 2 19 12 12 12 12 12 12 12 12 12 20 2 2 2 2 2 2 2 2 2 19 12 12 12 12 12 13 5 5 5 5 5 5 5 5 5 4 4 4 4 4 4 4 4 4
2 2 2 2 2 2 2 2 2 2 2 2 2 2 2 2 2 2 2 2 2 2 2 2 2 2 2 2 2 2 2 2 2 2 2 2 2 2 2 2 2 2 2 2 2 2 2 19 12 12 12 12 12 12 12 12 13 4 4 4 4 4 11 12 12 12
2 2 2 2 2 2 2 2 2 2 2 2 2 2 2 2 2 2 2 2 2 2 2 2 2 2 2 2 2 2 2 2 2 2 2 2 2 2 2 2 2 2 18 5 15 15 15 25 2 2 2 2 2 2 2 2 19 12 12 12 12 12 20 2 2 2
2 2 2 2 2 2 2 18 5 15 15 25 2 2 2 2 2 2 2 2 2 2 2 2 2 2 2 2 2 2 2 2 2 2 2 2 2 2 2 2 2 24 16 0 0 4 4 17 2 2 2 2 2 2 2 2 2 2 2 2 2 2 2 2 2 2
2 2 2 2 2 2 2 18 0 0 0 14 15 15 25 2 2 2 2 2 2 2 2 2 2 2 2 2 2 2 2 2 2 2 2 2 2 2 2 2 2 18 0 0 0 0 0 17 2 2 2 2 2 2 2 2 2 2 2 2 2 2 2 2 2 2
2 2 2 2 2 2 2 18 0 0 0 0 0 0 17 2 2 2 2 2 2 2 2 2 2 2 2 2 2 2 2 2 2 2 2 2 2 2 2 2 2 18 0 0 0 0 0 17 2 2 2 2 2 2 2 2 2 2 2 2 2 2 2 2 2 2
2 2 2 2 2 2 2 18 0 0 0 0 0 0 17 2 2 2 2 2 2 2 2 2 2 2 2 2 2 2 2 2 2 2 2 2 2 2 2 2 2 18 0 0 0 0 0 17 2 2 2 2 2 2 2 2 2 2 2 2 2 2 2 2 2 2