14 14 14 14 14 14 14 14 14 14 14 14 14 14 14 14 14 14 14 14 14 14 14 14 14 14 14 14 14 14 14 14 14 14 14 14 14 14 14 14 14 14 14 14 14 14 14 14 14 14
14 14 14 14 14 14 14 14 14 14 14 14 14 14 14 14 14 14 14 14 14 14 14 14 14 14 14 14 14 14 14 14 14 14 14 14 14 14 14 14 14 14 14 14 14 14 14 14 14 14
14 14 14 14 14 14 14 14 14 14 14 14 14 14 14 14 14 14 14 14 14 14 14 14 14 14 14 14 14 14 14 14 14 14 14 14 14 14 14 14 14 14 14 14 14 14 14 14 14 14
14 14 14 14 14 14 14 14 14 14 14 14 14 14 14 14 14 14 14 14 14 14 14 14 14 14 14 14 14 14 14 14 14 14 14 14 14 14 14 14 14 14 14 14 14 14 14 14 14 14
14 14 14 14 14 14 14 14 14 14 14 14 14 14 14 14 14 14 14 14 14 14 14 14 14 14 14 14 14 14 14 14 14 14 14 14 14 14 14 14 14 14 14 14 14 14 14 14 14 14
14 14 14 14 14 14 14 14 14 14 14 14 14 14 14 14 14 14 14 14 14 14 14 14 14 14 14 14 14 14 14 14 14 14 14 14 14 14 14 14 14 14 14 14 14 14 14 14 14 14
14 14 14 14 14 14 14 14 14 14 14 14 14 14 14 14 14 14 14 14 14 14 20 19 19 19 19 19 19 19 19 19 19 19 22 14 14 14 14 14 14 14 14 14 14 14 14 14 14 14
14 14 14 14 14 14 14 14 14 14 14 14 14 14 14 14 14 14 20 19 19 19 21 10 10 10 10 10 10 10 10 10 10 10 16 14 14 14 14 14 14 14 14 14 14 14 14 14 14 14
14 14 14 14 14 14 14 14 14 14 14 14 14 14 14 14 20 19 21 10 10 10 10 10 10 10 15 15 15 10 10 10 11 10 16 14 14 14 14 14 14 14 14 14 14 14 14 14 14 14
14 14 14 14 14 14 14 14 14 14 14 14 14 14 14 20 21 10 10 10 10 10 10 10 10 10 15 15 15 10 10 11 11 11 16 14 14 14 14 14 14 14 14 14 14 14 14 14 14 14
14 14 14 14 14 14 14 14 14 14 14 14 14 14 20 21 10 10 12 12 10 10 10 10 10 10 15 15 15 10 10 12 11 10 16 14 14 14 14 14 14 14 14 14 14 14 14 14 14 14
14 14 14 14 14 14 14 14 14 14 14 14 14 14 18 10 10 12 12 12 12 12 12 10 10 10 10 15 10 10 10 10 10 10 16 14 14 14 14 14 14 14 14 14 14 14 14 14 14 14
14 14 14 14 14 14 14 14 14 14 14 14 14 14 18 10 12 12 12 12 12 12 12 12 10 10 10 10 10 10 10 10 10 10 16 14 14 14 14 14 14 14 14 14 14 14 14 14 14 14
14 14 14 14 14 14 14 14 14 14 14 20 19 19 21 10 12 12 12 12 12 12 12 12 12 12 12 10 10 10 10 10 10 10 16 14 14 14 14 14 14 14 14 14 14 14 14 14 14 14
14 14 14 14 14 14 14 14 14 14 14 18 10 12 12 10 10 10 12 12 12 12 12 12 12 12 12 12 12 10 10 10 10 10 10 16 14 14 14 14 14 14 14 14 14 14 14 14 14 14 14
14 14 14 14 14 14 14 14 14 14 14 18 10 12 12 12 10 10 10 12 12 12 12 11 12 12 12 12 12 10 10 10 10 10 10 10 16 14 14 14 14 14 14 14 14 14 14 14 14 14 14 14
14 14 14 14 14 14 14 14 14 14 14 18 12 12 12 12 10 10 10 15 12 12 12 15 15 12 12 12 12 10 10 10 10 10 10 10 16 14 14 14 14 14 14 14 14 14 14 14 14 14 14 14
14 14 14 14 14 14 14 14 14 20 19 21 12 12 12 12 12 12 12 12 12 12 12 12 12 12 12 12 10 10 10 10 10 10 10 10 16 14 14 14 14 14 14 14 14 14 14 14 14 14 14 14
14 14 14 14 14 14 14 20 19 21 12 12 12 12 12 12 12 12 12 12 12 12 12 12 12 12 10 10 10 10 10 10 10 10 16 14 14 14 14 14 14 14 14 14 14 14 14 14 14 14
14 14 14 14 14 14 14 18 12 12 12 12 12 12 12 12 12 12 12 12 12 12 12 12 12 12 10 10 10 10 10 10 10 10 16 14 14 14 14 14 14 14 14 14 14 14 14 14 14 14
14 14 14 14 14 14 14 24 17 17 17 17 25 12 12 12 12 12 12 12 12 12 12 12 12 10 10 10 10 10 10 10 10 27 26 14 14 14 20 19 19 22 14 14 14 14 14 14 14 14
14 14 14 14 14 14 14 14 14 14 14 14 24 25 12 12 12 12 12 12 12 12 11 11 11 10 15 15 10 10 10 27 17 26 14 14 14 14 18 10 12 16 14 14 14 14 14 14 14 14
14 14 14 14 14 14 14 14 14 14 14 14 14 18 12 12 12 12 12 12 12 10 10 10 10 10 15 15 10 27 17 26 14 14 14 14 14 14 18 10 10 16 14 14 14 14 14 14 14 14
14 14 14 14 14 14 14 14 14 14 14 14 20 21 10 10 12 12 10 10 10 10 10 10 10 12 15 15 12 23 22 14 14 14 14 14 14 14 18 10 27 26 14 14 14 14 14 14 14 14
14 14 14 14 14 14 14 14 14 14 14 14 18 10 10 10 10 10 10 10 10 10 10 10 12 12 15 15 12 12 16 14 14 14 14 14 14 14 24 17 26 14 14 14 14 14 14 14 14 14
14 14 14 14 14 14 14 20 19 19 22 14 18 10 10 10 10 10 10 10 10 10 15 15 15 15 15 15 15 15 23 19 22 14 14 14 14 20 19 19 22 14 14 14 14 14 14 14 14 14
14 14 14 14 14 14 14 18 10 10 16 20 21 10 10 10 10 10 10 10 10 10 15 15 15 15 15 15 15 15 15 15 16 14 20 19 19 21 10 10 16 14 14 14 14 14 14 14 14 14
14 14 14 14 14 14 14 24 25 10 16 18 10 10 10 10 10 10 10 10 10 10 10 10 12 12 15 15 12 12 10 10 16 14 18 10 10 10 10 10 16 14 14 14 14 14 14 14 14 14
14 14 14 14 14 14 14 14 24 17 26 18 10 10 10 10 10 10 10 10 10 10 10 10 10 12 15 15 12 10 10 10 16 14 18 10 15 15 15 10 16 14 14 14 14 14 14 14 14 14
14 14 14 14 14 14 14 14 14 14 20 21 10 10 10 10 10 10 10 10 10 10 10 10 10 10 15 15 10 10 10 10 16 14 18 10 15 15 15 10 16 14 14 14 14 14 14 14 14 14
14 14 14 14 14 14 14 14 14 14 18 10 10 10 10 10 10 10 10 10 10 10 10 10 10 10 15 15 10 10 10 10 16 14 18 10 15 15 15 10 16 14 14 14 14 14 14 14 14 14
14 14 14 14 14 14 14 14 14 20 21 10 10 10 10 10 10 10 10 10 10 10 10 10 10 10 10 10 10 10 10 10 16 14 18 10 10 15 10 10 16 14 14 14 14 14 14 14 14 14
14 14 14 14 14 14 14 14 20 21 10 10 10 10 10 10 10 10 10 10 10 10 10 10 10 10 10 10 10 10 10 10 16 14 18 10 10 10 10 10 16 14 14 14 14 14 14 14 14 14
14 14 14 14 14 14 14 20 21 10 10 10 10 10 10 10 10 10 10 10 10 10 10 10 10 10 10 10 10 10 10 10 16 14 18 10 10 10 10 10 23 22 14 14 14 14 14 14 14 14
14 14 14 14 14 14 14 18 10 10 15 15 15 11 10 10 10 10 10 12 10 10 10 10 10 10 10 10 10 10 10 10 16 14 18 10 10 10 10 10 10 16 14 14 14 14 14 14 14 14
14 14 14 14 14 14 14 18 10 10 15 15 15 15 10 10 10 10 10 12 10 10 10 10 10 10 10 10 10 10 10 10 16 14 18 10 10 10 12 12 10 16 14 14 14 14 14 14 14 14
14 14 14 14 14 14 14 18 10 10 15 15 15 11 10 10 10 10 10 12 10 10 10 10 10 10 10 10 10 10 15 15 15 15 15 15 15 10 10 12 10 16 14 14 14 14 14 14 14 14
14 14 14 14 14 14 14 24 25 10 10 10 10 10 10 10 10 10 12 12 10 10 10 10 10 10 10 10 10 10 15 15 15 15 15 15 15 10 10 10 10 16 14 14 14 14 14 14 14 14
14 14 14 14 14 14 14 14 24 25 10 10 10 10 10 10 10 10 12 12 12 10 10 10 10 10 10 10 10 10 10 12 16 14 18 10 10 11 10 10 11 23 22 14 14 14 14 14 14 14
14 14 14 14 14 14 14 14 14 18 10 10 10 10 12 10 10 12 12 12 12 10 10 10 10 10 10 10 10 10 10 12 16 14 18 10 11 10 11 11 11 11 16 14 14 14 14 14 14 14
14 14 14 14 14 14 14 14 14 18 10 10 10 10 10 12 12 12 12 12 12 10 10 10 10 10 10 10 10 10 27 17 26 14 18 10 10 10 10 11 11 11 16 14 14 14 14 14 14 14
14 14 14 14 14 14 14 14 14 24 25 10 10 10 12 12 12 27 17 17 25 12 12 12 10 12 10 10 10 12 16 14 14 14 18 10 11 10 11 11 11 11 16 14 14 14 14 14 14 14
14 14 14 14 14 14 14 14 14 14 24 17 17 17 17 17 17 26 14 14 18 10 10 10 10 27 17 17 17 17 26 14 14 14 18 10 11 11 11 27 17 17 26 14 14 14 14 14 14 14
14 14 14 14 14 14 14 14 14 14 14 14 14 14 14 14 14 14 14 14 24 17 17 17 17 26 14 14 14 14 14 14 14 14 24 17 17 17 17 26 14 14 14 14 14 14 14 14 14 14
14 14 14 14 14 14 14 14 14 14 14 14 14 14 14 14 14 14 14 14 14 14 14 14 14 14 14 14 14 14 14 14 14 14 14 14 14 14 14 14 14 14 14 14 14 14 14 14 14 14
14 14 14 14 14 14 14 14 14 14 14 14 14 14 14 14 14 14 14 14 14 14 14 14 14 14 14 14 14 14 14 14 14 14 14 14 14 14 14 14 14 14 14 14 14 14 14 14 14 14
14 14 14 14 14 14 14 14 14 14 14 14 14 14 14 14 14 14 14 14 14 14 14 14 14 14 14 14 14 14 14 14 14 14 14 14 14 14 14 14 14 14 14 14 14 14 14 14 14 14
14 14 14 14 14 14 14 14 14 14 14 14 14 14 14 14 14 14 14 14 14 14 14 14 14 14 14 14 14 14 14 14 14 14 14 14 14 14 14 14 14 14 14 14 14 14 14 14 14 14
14 14 14 14 14 14 14 14 14 14 14 14 14 14 14 14 14 14 14 14 14 14 14 14 14 14 14 14 14 14 14 14 14 14 14 14 14 14 14 14 14 14 14 14 14 14 14 14 14 14
14 14 14 14 14 14 14 14 14 14 14 14 14 14 14 14 14 14 14 14 14 14 14 14 14 14 14 14 14 14 14 14 14 14 14 14 14 14 14 14 14 14 14 14 14 14 14 14 14 14