12 12 12 12 12 12 12 12 12 12 12 12 12 12 12 12 12 12 12 12 12 12 12 12 12 12 12 12 12 12 12 12 12 12 12 12 12 12 12 12 12 12 12 12 12 12 12 12 12 12
12 12 12 12 12 12 12 12 12 12 12 12 12 12 12 12 12 12 12 12 12 12 12 12 12 12 12 12 12 12 12 12 12 12 12 12 12 12 12 12 12 12 12 12 12 12 12 12 12 12
12 12 12 12 12 12 12 12 12 12 12 12 12 12 12 12 12 12 12 12 12 12 12 12 12 12 12 12 12 12 12 12 12 12 12 12 12 12 12 12 12 12 12 12 12 12 12 12 12 12
12 12 12 12 12 12 12 12 12 12 12 12 12 12 12 12 12 12 12 12 12 12 12 12 12 12 12 12 12 12 12 12 12 12 12 12 12 12 12 12 12 12 12 12 12 12 12 12 12 12
12 12 12 12 12 12 12 12 12 12 12 12 12 12 12 12 12 12 12 12 12 12 12 12 12 12 12 12 12 12 12 12 12 12 12 12 12 12 12 12 12 12 12 12 12 12 12 12 12 12
12 12 12 12 12 12 12 12 12 12 12 12 12 12 12 12 12 12 12 12 12 12 12 12 12 12 12 12 12 12 12 12 12 12 12 12 12 12 12 12 12 12 12 12 12 12 12 12 12 12
12 12 12 12 12 12 12 12 12 12 12 12 12 12 12 12 12 12 12 12 12 12 12 12 12 12 12 12 12 12 12 12 12 12 12 12 12 12 12 12 12 12 12 12 12 12 12 12 12 12
12 12 12 12 12 12 12 12 12 12 12 12 12 12 12 12 12 12 12 12 12 12 12 10 10 10 10 10 10 10 10 10 10 10 12 12 12 12 12 12 12 12 12 12 12 12 12 12 12 12
12 12 12 12 12 12 12 12 12 12 12 12 12 12 12 12 12 12 12 10 10 10 10 10 10 10 15 15 15 10 10 10 10 10 12 12 12 12 12 12 12 12 12 12 12 12 12 12 12 12
12 12 12 12 12 12 12 12 12 12 12 12 12 12 12 12 12 10 10 10 10 10 10 10 10 10 15 15 15 10 10 10 10 10 12 12 12 12 12 12 12 12 12 12 12 12 12 12 12 12
12 12 12 12 12 12 12 12 12 12 12 12 12 12 12 12 10 10 14 14 10 10 10 10 10 10 15 15 15 10 10 10 10 10 12 12 12 12 12 12 12 12 12 12 12 12 12 12 12 12
12 12 12 12 12 12 12 12 12 12 12 12 12 12 12 10 10 14 14 14 14 14 14 10 10 10 10 15 10 10 10 10 10 10 12 12 12 12 12 12 12 12 12 12 12 12 12 12 12 12
12 12 12 12 12 12 12 12 12 12 12 12 12 12 12 10 14 14 14 14 14 14 14 14 10 10 10 10 10 10 10 10 10 10 12 12 12 12 12 12 12 12 12 12 12 12 12 12 12 12
12 12 12 12 12 12 12 12 12 12 12 12 12 12 12 10 14 14 14 14 14 14 14 14 14 14 14 10 10 10 10 10 10 10 12 12 12 12 12 12 12 12 12 12 12 12 12 12 12 12
12 12 12 12 12 12 12 12 12 12 12 12 14 14 10 10 10 14 14 14 14 14 14 14 14 14 14 14 10 10 10 10 10 10 12 12 12 12 12 12 12 12 12 12 12 12 12 12 12 12
12 12 12 12 12 12 12 12 12 12 12 14 14 14 10 10 10 14 14 14 14 10 14 14 14 14 14 10 10 10 10 10 10 10 12 12 12 12 12 12 12 12 12 12 12 12 12 12 12 12
12 12 12 12 12 12 12 12 12 12 14 14 14 14 10 10 10 15 14 14 14 15 15 14 14 14 14 10 10 10 10 10 10 10 12 12 12 12 12 12 12 12 12 12 12 12 12 12 12 12
12 12 12 12 12 12 12 12 12 12 14 14 14 14 14 14 14 14 14 14 14 14 14 14 14 14 10 10 10 10 10 10 10 10 12 12 12 12 12 12 12 12 12 12 12 12 12 12 12 12
12 12 12 12 12 12 12 12 12 12 14 14 14 14 14 14 14 14 14 14 14 14 14 14 14 14 10 10 10 10 10 10 10 10 12 12 12 12 12 12 12 12 12 12 12 12 12 12 12 12
12 12 12 12 12 12 12 12 14 14 12 14 14 14 14 14 14 14 14 14 14 14 14 14 14 14 10 10 10 10 10 10 10 10 12 12 12 12 12 12 12 12 12 12 12 12 12 12 12 12
12 12 12 12 12 12 12 12 12 12 12 12 12 14 14 14 14 14 14 14 14 14 14 14 14 10 10 10 10 10 10 10 10 12 12 12 12 12 12 12 12 12 12 12 12 12 12 12 12 12
12 12 12 12 12 12 12 12 12 12 12 12 12 12 14 14 14 14 14 14 14 14 10 10 10 10 10 10 10 10 10 12 12 12 12 12 12 12 12 12 12 12 12 12 12 12 12 12 12 12
12 12 12 12 12 12 12 12 12 12 12 12 12 12 14 14 14 14 14 14 14 10 10 10 10 10 15 10 10 12 12 12 12 12 12 12 12 12 12 12 10 12 12 12 12 12 12 12 12 12
12 12 12 12 12 12 12 12 12 12 12 12 12 12 10 10 14 14 10 10 10 10 10 10 10 14 15 14 10 12 12 12 12 12 12 12 12 12 12 10 10 12 12 12 12 12 12 12 12 12
12 12 12 12 12 12 12 12 12 12 12 12 12 10 10 10 10 10 10 10 10 10 10 10 15 15 15 15 15 12 12 12 12 12 12 12 12 12 12 10 10 12 12 12 12 12 12 12 12 12
12 12 12 12 12 12 12 12 12 12 12 12 12 10 10 10 10 10 10 10 10 10 10 14 15 15 15 15 15 14 12 12 12 12 12 12 12 12 12 12 12 12 12 12 12 12 12 12 12 12
12 12 12 12 12 12 12 12 12 12 12 12 12 10 10 10 10 10 10 10 10 10 15 15 15 15 15 15 15 10 10 10 12 12 12 12 12 12 10 10 12 12 12 12 12 12 12 12 12 12
12 12 12 12 12 12 12 12 12 12 10 12 10 10 10 10 10 10 10 10 10 10 10 14 15 15 15 15 15 14 10 10 12 12 12 10 10 10 10 10 12 12 12 12 12 12 12 12 12 12
12 12 12 12 12 12 12 12 12 12 10 12 10 10 10 10 10 10 10 10 10 10 10 10 15 15 15 15 15 10 10 10 12 12 10 10 15 15 15 10 12 12 12 12 12 12 12 12 12 12
12 12 12 12 12 12 12 12 12 12 12 10 10 10 10 10 10 10 10 10 10 10 10 10 10 14 15 14 10 10 10 10 12 12 10 10 15 15 15 10 12 12 12 12 12 12 12 12 12 12
12 12 12 12 12 12 12 12 12 12 12 10 10 10 10 10 10 10 10 10 10 10 10 10 10 10 15 10 10 10 10 10 12 12 10 10 15 15 15 10 12 12 12 12 12 12 12 12 12 12
12 12 12 12 12 12 12 12 12 12 12 10 10 10 10 10 10 10 10 10 10 10 10 10 10 10 10 10 10 10 10 10 12 12 10 10 10 15 10 10 12 12 12 12 12 12 12 12 12 12
12 12 12 12 12 12 12 12 12 12 10 10 10 10 10 10 10 10 10 10 10 10 10 10 10 10 10 10 10 10 10 10 12 12 10 10 10 10 10 10 12 12 12 12 12 12 12 12 12 12
12 12 12 12 12 12 12 12 12 10 10 10 10 10 10 10 10 10 10 10 10 10 10 10 10 10 10 10 10 10 10 10 12 12 10 10 10 10 10 10 12 12 12 12 12 12 12 12 12 12
12 12 12 12 12 12 12 12 10 10 15 15 15 10 10 10 10 10 10 14 10 10 10 10 10 10 10 10 10 10 10 10 12 12 10 10 10 10 10 10 10 12 12 12 12 12 12 12 12 12
12 12 12 12 12 12 12 12 10 10 15 15 15 15 10 10 10 10 10 14 10 10 10 10 10 10 10 10 10 10 10 10 12 12 10 10 10 14 14 10 10 12 12 12 12 12 12 12 12 12
12 12 12 12 12 12 12 12 10 10 15 15 15 10 10 10 10 10 10 14 10 10 10 10 10 10 10 10 10 10 15 15 15 15 15 10 10 10 14 10 10 12 12 12 12 12 12 12 12 12
12 12 12 12 12 12 12 12 12 10 10 10 10 10 10 10 10 10 14 14 10 10 10 10 10 10 10 10 10 10 15 15 15 15 15 10 10 10 10 10 10 12 12 12 12 12 12 12 12 12
12 12 12 12 12 12 12 12 12 12 10 10 10 10 10 10 10 10 14 14 14 10 10 10 10 10 10 10 10 10 10 14 12 12 10 10 10 10 10 10 10 12 12 12 12 12 12 12 12 12
12 12 12 12 12 12 12 12 12 12 10 10 10 10 14 10 10 14 14 14 14 10 10 10 10 10 10 10 10 10 10 14 12 12 10 10 10 10 10 10 10 10 12 12 12 12 12 12 12 12
12 12 12 12 12 12 12 12 12 12 10 10 10 10 10 14 14 14 14 12 14 10 10 10 10 10 10 10 10 10 12 12 12 12 10 10 10 10 10 10 10 10 12 12 12 12 12 12 12 12
12 12 12 12 12 12 12 12 12 12 12 10 10 10 14 14 14 12 12 12 14 14 14 14 10 14 10 10 10 14 12 12 12 12 10 10 10 10 10 10 10 10 12 12 12 12 12 12 12 12
12 12 12 12 12 12 12 12 12 12 12 12 12 12 12 12 12 12 12 12 14 14 10 10 10 10 12 12 12 12 12 12 12 12 12 10 10 10 10 10 12 12 12 12 12 12 12 12 12 12
12 12 12 12 12 12 12 12 12 12 12 12 12 12 12 12 12 12 12 12 12 12 12 12 12 12 12 12 12 12 12 12 12 12 12 12 12 12 12 12 12 12 12 12 12 12 12 12 12 12
12 12 12 12 12 12 12 12 12 12 12 12 12 12 12 12 12 12 12 12 12 12 12 12 12 12 12 12 12 12 12 12 12 12 12 12 12 12 12 12 12 12 12 12 12 12 12 12 12 12
12 12 12 12 12 12 12 12 12 12 12 12 12 12 12 12 12 12 12 12 12 12 12 12 12 12 12 12 12 12 12 12 12 12 12 12 12 12 12 12 12 12 12 12 12 12 12 12 12 12
12 12 12 12 12 12 12 12 12 12 12 12 12 12 12 12 12 12 12 12 12 12 12 12 12 12 12 12 12 12 12 12 12 12 12 12 12 12 12 12 12 12 12 12 12 12 12 12 12 12
12 12 12 12 12 12 12 12 12 12 12 12 12 12 12 12 12 12 12 12 12 12 12 12 12 12 12 12 12 12 12 12 12 12 12 12 12 12 12 12 12 12 12 12 12 12 12 12 12 12
12 12 12 12 12 12 12 12 12 12 12 12 12 12 12 12 12 12 12 12 12 12 12 12 12 12 12 12 12 12 12 12 12 12 12 12 12 12 12 12 12 12 12 12 12 12 12 12 12 12
12 12 12 12 12 12 12 12 12 12 12 12 12 12 12 12 12 12 12 12 12 12 12 12 12 12 12 12 12 12 12 12 12 12 12 12 12 12 12 12 12 12 12 12 12 12 12 12 12 12